1 1 1 1 1 1 1 1 1 1 1 1 1 1 1 1 1 1 1 1 1 1 1 1 1 1 1 1 1 1 1 1 1 1 1 1 1 1 1 1 1 1 1 1 1 1 1 1 1 1 1 1 1 1 1 1 1 1 1 1 1 1 1 
1 20 20 20 20 20 20 20 20 20 20 20 20 20 20 20 20 20 20 20 20 20 20 20 20 20 20 20 20 20 20 20 20 20 20 20 20 20 20 20 20 20 20 20 20 20 20 20 20 20 20 20 20 20 20 20 20 20 20 20 20 1 1
1 20 2 2 2 2 2 2 2 2 2 2 2 2 2 2 2 2 2 2 2 2 2 20 20 20 20 20 20 20 20 20 20 20 20 20 20 20 20 20 20 20 20 20 20 2 2 2 2 2 2 2 2 2 2 2 2 2 2 2 20 1 1
1 20 2 41 41 41 41 41 41 41 41 41 41 41 41 41 41 41 41 41 41 2 2 20 20 20 20 20 20 20 20 20 20 20 20 20 20 20 20 20 20 20 20 20 20 2 22 22 22 22 22 22 22 22 22 22 22 22 2 2 20 1 1 
1 20 2 41 41 41 41 41 41 41 41 41 41 41 41 41 41 41 41 41 41 2 2 20 20 20 20 20 20 20 20 20 20 20 20 20 20 20 20 20 20 20 20 20 20 2 22 22 22 22 22 22 22 22 22 22 22 22 2 2 20 1 1
1 20 2 41 41 41 41 41 41 41 41 41 41 41 41 41 41 41 41 41 41 2 2 20 20 20 20 20 20 20 20 20 20 20 20 20 20 20 20 20 20 20 20 20 20 2 22 22 22 22 22 22 22 22 22 22 22 22 2 2 20 1 1
1 20 2 41 41 41 41 41 41 41 41 41 41 41 41 41 41 41 41 41 41 2 3 3 3 3 3 3 3 3 3 3 3 3 3 3 3 3 3 3 3 3 3 3 3 2 22 22 22 22 22 22 22 22 22 22 22 22 2 2 20 1 1
1 20 2 41 41 41 41 41 41 41 41 41 41 41 41 41 41 41 41 41 41 41 62 62 62 62 62 62 62 62 62 62 62 62 62 62 62 62 62 62 62 62 62 62 62 62 22 22 22 22 22 22 22 22 22 22 22 22 2 2 20 1 1
1 20 2 41 41 41 41 41 41 41 41 41 41 41 41 41 41 41 41 41 41 41 62 62 62 62 62 62 62 62 62 62 62 62 62 62 62 62 62 62 62 62 62 62 62 62 22 22 22 22 22 22 22 22 22 22 22 22 2 2 20 1 1
1 20 2 41 41 41 41 41 41 41 41 41 41 41 41 41 41 41 41 41 41 2 3 3 3 3 3 3 3 3 3 3 3 62 62 3 3 3 3 3 3 3 3 3 3 2 22 22 22 22 22 22 22 22 22 22 22 22 2 2 20 1 1
1 20 2 41 41 41 41 41 41 41 41 41 41 41 41 41 41 41 41 41 41 2 2 20 20 20 20 20 20 20 20 20 3 62 62 3 20 20 20 20 20 20 20 20 20 2 22 22 22 22 22 22 22 22 22 22 22 22 2 2 20 1 1
1 20 2 41 41 41 41 41 41 41 41 41 41 41 41 41 41 41 41 41 41 2 2 20 20 20 20 20 20 20 20 20 3 62 62 3 20 20 20 20 20 20 20 20 20 2 22 22 22 22 22 22 22 22 22 22 22 22 2 2 20 1 1
1 20 2 41 41 41 41 41 41 41 41 41 41 41 41 41 41 41 41 41 41 2 2 20 20 20 20 20 20 20 20 20 3 62 62 3 20 20 20 20 20 20 20 20 20 2 22 22 22 22 22 22 22 22 22 22 22 22 2 2 20 1 1
1 20 2 2 2 2 2 2 2 2 41 41 41 2 2 2 2 2 2 2 2 2 2 20 20 20 20 20 20 20 20 20 3 62 62 3 20 20 20 20 20 20 20 20 20 2 2 2 2 2 2 2 2 2 2 2 22 22 2 2 20 1 1
1 20 20 20 20 20 20 20 20 3 23 23 23 3 3 20 20 20 20 20 20 20 20 20 20 20 20 20 20 20 20 20 3 62 62 3 20 20 20 20 20 20 20 20 20 20 20 20 20 20 20 20 20 20 20 4 43 43 4 4 20 1 1
1 20 20 20 20 20 20 20 20 3 23 23 23 3 3 20 20 20 20 20 20 20 20 20 20 20 20 20 20 20 20 20 3 62 62 3 20 20 20 20 20 20 20 20 20 20 20 20 20 20 20 20 20 20 20 4 43 43 4 4 20 1 1
1 20 20 20 20 20 20 20 20 3 23 23 23 3 3 20 20 20 20 20 20 20 20 20 20 20 20 20 20 20 20 20 3 62 62 3 20 20 20 20 20 20 20 20 20 20 20 20 20 20 20 20 20 20 20 4 43 43 4 4 20 1 1
1 20 20 20 20 20 20 20 20 3 23 23 23 3 3 20 20 20 20 20 20 20 20 20 20 20 20 20 20 20 20 20 3 62 62 3 20 20 20 20 20 20 20 20 20 20 20 20 20 20 20 20 20 20 20 4 43 43 4 4 20 1 1
1 20 20 20 20 20 20 20 20 3 23 23 23 3 3 20 20 20 20 20 20 20 20 20 20 20 20 20 20 20 20 20 3 62 62 3 20 20 20 20 20 20 20 20 20 20 20 20 20 20 20 20 20 20 20 4 43 43 4 4 20 1 1
1 20 20 20 20 20 20 20 20 3 23 23 23 3 3 20 20 20 20 20 20 20 20 20 20 20 20 20 20 20 20 20 3 62 62 3 20 20 20 20 20 20 20 20 20 20 20 20 20 20 20 20 20 20 20 4 43 43 4 4 20 1 1
1 20 20 20 20 20 20 20 20 3 23 23 23 3 3 20 20 20 20 20 20 20 1 1 1 1 1 1 1 1 1 1 1 20 20 1 1 1 1 1 1 1 1 1 1 1 1 20 20 20 20 20 20 20 20 4 43 43 4 4 20 1 1
1 20 20 20 20 20 20 20 20 3 23 23 23 3 3 20 20 20 20 20 20 20 1 20 20 20 20 20 20 20 20 20 20 20 20 20 20 20 20 20 20 20 20 20 20 1 1 20 20 20 20 20 20 20 20 4 43 43 4 4 20 1 1
1 20 20 20 20 20 20 20 20 3 23 23 23 3 3 20 20 20 20 20 20 20 1 20 20 20 20 20 20 20 20 20 20 20 20 20 20 20 20 20 20 20 20 20 20 1 1 20 20 20 20 20 20 20 20 4 43 43 4 4 20 1 1
1 20 20 20 20 20 20 20 20 3 23 23 23 3 3 20 20 20 20 20 20 20 1 20 20 20 20 20 20 20 20 20 20 20 20 20 20 20 20 20 20 20 20 20 20 1 1 20 20 20 20 20 20 20 20 4 43 43 4 4 20 1 1
1 20 20 20 20 20 20 20 20 3 23 23 23 3 3 20 20 20 20 20 20 20 1 20 20 20 20 20 20 20 20 20 20 20 20 20 20 20 20 20 20 20 20 20 20 1 1 20 20 20 20 20 20 20 20 4 43 43 4 4 20 1 1
1 20 20 20 20 20 20 20 20 3 23 23 23 3 3 20 20 20 20 20 20 20 1 20 20 20 20 20 20 20 20 20 20 20 20 20 20 20 20 20 20 20 20 20 20 1 1 20 20 20 20 20 20 20 20 4 43 43 4 4 20 1 1
1 20 20 20 20 20 20 20 20 3 23 23 23 3 3 3 3 3 3 3 3 3 1 20 20 20 20 20 20 20 20 20 20 20 20 20 20 20 20 20 20 20 20 20 20 1 4 4 4 4 4 4 4 4 4 4 43 43 4 4 20 1 1
1 20 20 20 20 20 20 20 20 3 23 23 23 23 23 23 23 23 23 23 23 23 20 20 20 20 20 20 20 20 20 20 20 20 20 20 20 20 20 20 20 20 20 20 20 20 43 43 43 43 43 43 43 43 43 43 43 43 4 4 20 1 1
1 20 20 20 20 20 20 20 20 3 23 23 23 23 23 23 23 23 23 23 23 23 20 20 20 20 20 20 20 20 20 20 20 20 20 20 20 20 20 20 20 20 20 20 20 20 43 43 43 43 43 43 43 43 43 43 43 43 4 4 20 1 1
1 20 20 20 20 20 20 20 20 3 23 23 23 23 23 23 23 23 23 23 23 23 20 20 20 20 20 20 20 20 20 20 20 20 20 20 20 20 20 20 20 20 20 20 20 1 4 4 4 4 4 4 4 4 4 4 4 4 4 4 20 1 1
1 20 20 20 20 20 20 20 20 3 3 3 3 3 3 3 3 3 3 3 3 3 1 20 20 20 20 20 20 20 20 20 20 20 20 20 20 20 20 20 20 20 20 20 20 1 1 20 20 20 20 20 20 20 20 20 20 20 20 20 20 1 1
1 20 20 20 20 20 20 20 20 20 20 20 20 20 20 20 20 20 20 20 20 20 1 20 20 20 20 20 20 20 20 20 20 20 20 20 20 20 20 20 20 20 20 20 20 1 1 20 20 20 20 20 20 20 20 20 20 20 20 20 20 1 1
1 20 20 20 20 20 20 20 20 20 20 20 20 20 20 20 20 20 20 20 20 20 1 20 20 20 20 20 20 20 20 20 20 20 20 20 20 20 20 20 20 20 20 20 20 1 1 20 20 20 20 20 20 20 20 20 20 20 20 20 20 1 1
1 20 20 20 20 20 20 20 20 20 20 20 20 20 20 20 20 20 20 20 20 20 1 20 20 20 20 20 20 20 20 20 20 20 20 20 20 20 20 20 20 20 20 20 20 1 1 20 20 20 20 20 20 20 20 20 20 20 20 20 20 1 1
1 20 20 20 20 20 20 20 20 20 20 20 20 20 20 20 20 20 20 20 20 20 1 1 1 1 1 1 1 1 1 1 1 1 1 1 1 1 1 1 1 1 1 1 1 1 1 20 20 20 20 20 20 20 20 20 20 20 20 20 20 1 1
1 20 20 20 20 20 20 20 20 20 20 20 20 20 20 20 20 20 20 20 20 20 20 20 20 20 20 20 20 20 20 20 20 20 20 20 20 20 20 20 20 20 20 20 20 20 20 20 20 20 20 20 20 20 20 20 20 20 20 20 20 1 1
1 1 1 1 1 1 1 1 1 1 1 1 1 1 1 1 1 1 1 1 1 1 1 1 1 1 1 1 1 1 1 1 1 1 1 1 1 1 1 1 1 1 1 1 1 1 1 1 1 1 1 1 1 1 1 1 1 1 1 1 1 1 1
