3 3 3 3 3 3 3 3 3 3 3 3 3 3 3 3 3 3 3 4 4
4 20 20 20 20 20 20 20 20 20 20 20 20 20 20 20 20 20 20 4 4
4 20 20 20 20 20 20 20 20 20 20 20 20 20 20 20 20 20 20 4 4
4 20 20 20 20 20 20 20 20 20 20 20 20 20 20 20 20 20 20 4 4
4 20 20 20 20 20 20 20 20 20 20 20 20 20 20 20 20 20 20 4 4
4 20 20 20 20 20 20 20 20 20 20 20 20 20 20 20 20 20 20 4 4
4 20 20 20 20 20 20 2 4 2 4 2 4 2 4 20 20 20 20 4 4
4 20 20 20 20 20 20 4 3 3 3 3 3 3 2 20 20 20 20 4 4
4 20 20 20 20 20 20 2 3 20 20 20 20 3 4 20 20 20 20 4 4
4 20 20 20 20 20 20 4 3 20 20 20 20 3 2 20 20 20 20 4 4
4 20 20 20 20 20 20 20 20 20 20 20 20 3 4 20 20 20 20 4 4
4 20 20 20 20 20 20 20 20 20 20 20 20 3 2 20 20 20 20 4 4
4 20 20 20 20 20 20 4 3 20 20 20 20 3 4 20 20 20 20 4 4
4 20 20 20 20 20 20 2 3 20 20 20 20 3 2 20 20 20 20 4 4
4 20 20 20 20 20 20 4 3 20 20 20 20 3 4 20 20 20 20 4 4
4 20 20 20 20 20 20 2 3 3 3 3 3 3 2 20 20 20 20 4 4
3 3 3 3 3 3 3 3 3 3 3 3 3 3 3 3 3 3 3 4 4
